G G G G G G G G G G
G T T G G G G G G G
G V V G G G G G G G
G G G G V V V V G G
G G G G G G G G G G
G G G G G G G G G G

