G G G G G G G G G G
T T T T G G G G G G
V V V V T G G T G G
V V V V T T G G G G
V V V V V V G G G G
G G G G G G G G G G
